1111111111111111111111111111111111
1000110001000000000010001100011101
1110000000000000000000C000C1011101
11100001011000P0000000100001011101
100000000110000000000E000111011101
1111111101111111111111111101011101
1000000000A00000000000001010101101
1111111111111111111111110001011101
100000000000A000000A00000000001111
1011101111111111111111111111111101
10100000000000000A0000000000000001
1111111111111111111111111111111111