1111111111111111111111111111111111
100011000100C000000010001100011101
1110110101111111111010101101011101
1110000101101111111000100001011101
111111110110000000000E000111011101
1111111101111111111111111101011101
100000000000P000C00000000101011101
1111111111111111111111110001011101
100000000000C000000000000000011101
1011101111111111111111111111111101
1010000000C00C00000000000000000001
1111111111111111111111111111111111